000890030
000034000
030000006
900000400
004006700
000000002
500000080
000210000
080050000